%%%%%
%R T%
%   %
%MS %
%%%%%
